1 2 1 1 3 4 1 1 1 5 6 7 6 3 1 1 
1 1 1 8 1 4 1 1 1 4 1 1 1 1 9 1 
1 1 1 1 1 10 11 12 12 12 12 12
1 1 1 13 14 15 1 1 1 1 1 1 1 1 1 16 
1 17 1 1 1 1 2 18 1 1 10 16 1 19 1 1 
1 20 21 22 1 1 23 12 12 12 12 12
1 1 1 1 1 1 1 1 1 1 1 1 1 1 1 1 
1 1 13 16 24 25 26 27 28 28 29 1 1 1 19 1 
1 1 1 30 1 21 23 12 12 12 12 12
1 1 1 1 1 1 1 1 1 1 1 1 1 1 1 1 
1 1 1 1 1 1 31 1 1 1 1 1 1 1 1 1 
1 1 1 30 1 1 23 12 12 12 12 12
1 32 33 34 1 35 1 1 36 37 38 39 40 1 1 1 
1 1 41 1 1 1 1 1 1 32 42 1 1 1 1 1 
1 1 43 44 45 46 47 12 12 12 12 12
48 49 50 51 52 53 54 55 56 57 1 58 59 60 61 62 
1 1 1 1 63 64 65 66 1 67 67 1 1 68 69 70 
1 71 72 73 1 74 75 12 76 77 78 79
80 81 82 83 84 85 86 87 88 89 90 91 92 93 94 95 
96 97 98 99 100 101 102 103 104 105 106 107 108 109 110 111 
112 113 114 115 116 117 118 119 120 121 119 122
12 12 12 12 12 12 12 12 12 12 12 12 12 12 12 12 
12 12 12 12 12 12 12 12 12 12 12 12 12 12 123 124 
125 126 127 127 128 124 129 12 12 12 12 12
12 12 12 12 12 12 12 12 12 12 12 12 12 12 12 12 
12 12 12 12 12 12 12 12 12 12 12 12 12 12 130 131 
132 12 12 133 134 131 132 12 12 12 12 12
12 12 12 12 12 12 12 12 12 12 12 12 12 12 12 12 
12 12 12 12 12 12 12 12 12 12 12 12 12 12 130 131 
135 136 137 138 131 131 132 12 12 12 12 12